TimeStamp,ValueNum,Validity,ValueString
12.10.2023 00:04:24,527.2635,1,
12.10.2023 00:14:24,529.175,1,
12.10.2023 00:24:25,531.2131,1,
12.10.2023 00:34:25,531.1498,1,
12.10.2023 00:44:26,532.6183,1,
12.10.2023 00:54:26,532.9095,1,
12.10.2023 01:04:26,530.6942,1,
12.10.2023 01:14:27,531.2132,1,
12.10.2023 01:24:27,530.8207,1,
12.10.2023 01:34:28,527.8584,1,
12.10.2023 01:44:28,525.8203,1,
12.10.2023 01:54:28,526.0861,1,
12.10.2023 02:04:32,527.8331,1,
12.10.2023 02:14:33,529.9219,1,
12.10.2023 02:24:33,531.0486,1,
12.10.2023 02:34:34,531.3397,1,
12.10.2023 02:44:34,532.2004,1,
12.10.2023 02:54:35,532.5296,1,
12.10.2023 03:04:36,530.8207,1,
12.10.2023 03:14:40,530.6434,1,
12.10.2023 03:24:45,530.4662,1,
12.10.2023 03:34:49,527.1748,1,
12.10.2023 03:44:52,525.2761,1,
12.10.2023 03:54:53,525.4785,1,
12.10.2023 04:04:54,526.6938,1,
12.10.2023 04:14:54,528.7572,1,
12.10.2023 04:24:55,530.3269,1,
12.10.2023 04:34:55,530.922,1,
12.10.2023 04:44:56,531.922,1,
12.10.2023 04:54:56,532.1752,1,
12.10.2023 05:04:57,532.0107,1,
12.10.2023 05:14:57,531.5676,1,
12.10.2023 05:24:58,530.6561,1,
12.10.2023 05:34:58,528.2129,1,
12.10.2023 05:44:59,526.0989,1,
12.10.2023 05:54:59,525.9342,1,
12.10.2023 06:05:00,527.3774,1,
12.10.2023 06:15:00,529.4789,1,
12.10.2023 06:25:00,531.1498,1,
12.10.2023 06:35:01,531.6942,1,
12.10.2023 06:45:01,532.517,1,
12.10.2023 06:55:02,532.1372,1,
12.10.2023 07:05:02,532.2385,1,
12.10.2023 07:15:03,532.0233,1,
12.10.2023 07:25:03,531.403,1,
12.10.2023 07:35:04,528.7952,1,
12.10.2023 07:45:04,526.5166,1,
12.10.2023 07:55:05,526.2255,1,
12.10.2023 08:05:05,527.8711,1,
12.10.2023 08:15:06,529.8839,1,
12.10.2023 08:25:06,531.4916,1,
12.10.2023 08:35:06,532.5803,1,
12.10.2023 08:45:07,533.3399,1,
12.10.2023 08:55:07,533.0487,1,
12.10.2023 09:05:08,531.2258,1,
12.10.2023 09:15:08,531.1118,1,
12.10.2023 09:25:09,530.6055,1,
12.10.2023 09:35:09,527.7191,1,
12.10.2023 09:45:09,526.0608,1,
12.10.2023 09:55:10,525.3013,1,
12.10.2023 10:05:10,527.7192,1,
12.10.2023 10:15:11,529.6434,1,
12.10.2023 10:25:11,530.8207,1,
12.10.2023 10:35:11,531.5802,1,
12.10.2023 10:45:12,532.3777,1,
12.10.2023 10:55:12,531.7955,1,
12.10.2023 11:05:13,530.5802,1,
12.10.2023 11:15:13,529.7826,1,
12.10.2023 11:25:13,529.0104,1,
12.10.2023 11:35:14,526.8583,1,
12.10.2023 11:45:14,523.8834,1,
12.10.2023 11:55:14,523.9341,1,
12.10.2023 12:05:15,526.0609,1,
12.10.2023 12:15:15,527.7952,1,
12.10.2023 12:25:15,528.6686,1,
12.10.2023 12:35:16,530.6561,1,
12.10.2023 12:45:16,531.327,1,
12.10.2023 12:55:16,530.4662,1,
12.10.2023 13:05:17,529.732,1,
12.10.2023 13:15:17,529.6561,1,
12.10.2023 13:25:18,527.9977,1,
12.10.2023 13:35:18,525.5672,1,
12.10.2023 13:45:19,523.2252,1,
12.10.2023 13:55:19,522.9594,1,
12.10.2023 14:05:20,524.9975,1,
12.10.2023 14:15:20,526.8203,1,
12.10.2023 14:25:21,527.9977,1,
12.10.2023 14:35:21,529.0483,1,
12.10.2023 14:45:22,529.7826,1,
12.10.2023 14:55:22,530.1624,1,
12.10.2023 15:05:23,528.3775,1,
12.10.2023 15:15:23,528.0862,1,
12.10.2023 15:25:24,527.3901,1,
12.10.2023 15:35:24,524.5924,1,
12.10.2023 15:45:25,522.972,1,
12.10.2023 15:55:25,522.0226,1,
12.10.2023 16:05:26,525.757,1,
12.10.2023 16:15:26,526.5167,1,
12.10.2023 16:25:27,527.0228,1,
12.10.2023 16:35:27,528.504,1,
12.10.2023 16:45:28,529.4282,1,
12.10.2023 16:55:28,530.0232,1,
12.10.2023 17:05:28,528.58,1,
12.10.2023 17:15:29,528.8079,1,
12.10.2023 17:25:29,527.4534,1,
12.10.2023 17:35:30,524.9595,1,
12.10.2023 17:45:30,522.377,1,
12.10.2023 17:55:30,522.5542,1,
12.10.2023 18:05:31,524.8708,1,
12.10.2023 18:15:31,526.4913,1,
12.10.2023 18:25:32,527.3268,1,
12.10.2023 18:35:32,528.4155,1,
12.10.2023 18:45:32,529.5295,0,
12.10.2023 18:55:34,528.9598,1,
12.10.2023 19:05:34,527.7698,1,
12.10.2023 19:15:34,528.3522,1,
12.10.2023 19:25:35,527.3901,1,
12.10.2023 19:35:35,524.605,1,
12.10.2023 19:45:36,523.4023,1,
12.10.2023 19:55:36,522.225,1,
12.10.2023 20:05:36,523.8328,1,
12.10.2023 20:15:37,526.1622,1,
12.10.2023 20:25:37,525.8203,1,
12.10.2023 20:35:38,527.9976,1,
12.10.2023 20:45:38,528.9218,1,
12.10.2023 20:55:38,529.1116,1,
12.10.2023 21:05:39,527.618,1,
12.10.2023 21:15:39,527.4407,1,
12.10.2023 21:25:39,526.6052,1,
12.10.2023 21:35:40,523.7822,1,
12.10.2023 21:45:40,521.8074,1,
12.10.2023 21:55:41,521.5162,1,
12.10.2023 22:05:41,524.0988,1,
12.10.2023 22:15:41,525.4279,1,
12.10.2023 22:25:42,526.6052,1,
12.10.2023 22:35:42,527.4407,1,
12.10.2023 22:45:44,528.6433,1,
12.10.2023 22:55:45,528.3648,1,
12.10.2023 23:05:49,527.1622,1,
12.10.2023 23:15:54,527.5294,1,
12.10.2023 23:25:54,525.681,1,
12.10.2023 23:35:55,523.4404,1,
