TimeStamp,ValueNum,Validity,ValueString
15.10.2023 00:09:33,550,1,
15.10.2023 00:19:33,550,1,
15.10.2023 00:29:34,550,1,
15.10.2023 00:39:34,550,1,
15.10.2023 00:49:34,550,1,
15.10.2023 00:59:35,550,1,
15.10.2023 01:09:35,550,1,
15.10.2023 01:19:36,550,1,
15.10.2023 01:29:36,550,1,
15.10.2023 01:39:37,550,1,
15.10.2023 01:39:37,550,1,
15.10.2023 01:49:37,550,1,
15.10.2023 01:59:38,550,1,
15.10.2023 02:09:38,550,1,
15.10.2023 02:19:38,550,1,
15.10.2023 02:29:39,550,1,
15.10.2023 02:39:39,550,1,
15.10.2023 02:39:39,550,1,
15.10.2023 02:49:40,550,1,
15.10.2023 02:59:40,550,1,
15.10.2023 03:09:41,550,1,
15.10.2023 03:19:41,550,1,
15.10.2023 03:29:42,550,1,
15.10.2023 03:39:42,550,1,
15.10.2023 03:39:42,550,1,
15.10.2023 03:49:43,550,1,
15.10.2023 03:59:43,550,1,
15.10.2023 04:09:44,550,1,
15.10.2023 04:19:44,550,1,
15.10.2023 04:29:45,550,1,
15.10.2023 04:39:45,550,1,
15.10.2023 04:39:45,550,1,
15.10.2023 04:49:46,550,1,
15.10.2023 04:59:46,550,1,
15.10.2023 05:09:46,550,1,
15.10.2023 05:19:47,550,1,
15.10.2023 05:29:47,550,1,
15.10.2023 05:39:48,550,1,
15.10.2023 05:39:48,550,1,
15.10.2023 05:49:48,550,1,
15.10.2023 05:59:49,550,1,
15.10.2023 06:09:50,550,1,
15.10.2023 06:19:50,550,1,
15.10.2023 06:29:50,550,1,
15.10.2023 06:39:51,550,1,
15.10.2023 06:39:51,550,1,
15.10.2023 06:49:51,550,1,
15.10.2023 06:59:52,550,1,
15.10.2023 07:09:52,550,1,
15.10.2023 07:19:53,550,1,
15.10.2023 07:29:53,550,1,
15.10.2023 07:39:54,550,1,
15.10.2023 07:39:54,550,1,
15.10.2023 07:49:54,550,1,
15.10.2023 07:59:55,550,1,
15.10.2023 08:09:55,550,1,
15.10.2023 08:19:55,550,1,
15.10.2023 08:29:56,550,1,
15.10.2023 08:39:56,550,1,
15.10.2023 08:39:56,550,1,
15.10.2023 08:49:57,550,1,
15.10.2023 08:59:57,550,1,
15.10.2023 09:09:58,550,1,
15.10.2023 09:19:58,550,1,
15.10.2023 09:29:59,550,1,
15.10.2023 09:39:59,550,1,
15.10.2023 09:39:59,550,1,
15.10.2023 09:50:00,550,1,
15.10.2023 10:00:00,550,1,
15.10.2023 10:10:01,550,1,
15.10.2023 10:20:01,550,1,
15.10.2023 10:30:02,550,1,
15.10.2023 10:40:02,550,1,
15.10.2023 10:40:02,550,1,
15.10.2023 10:50:03,550,1,
15.10.2023 11:00:03,550,1,
15.10.2023 11:10:04,550,1,
15.10.2023 11:20:04,550,1,
15.10.2023 11:30:08,550,1,
15.10.2023 11:40:10,550,1,
15.10.2023 11:40:10,550,1,
15.10.2023 11:50:11,550,1,
15.10.2023 12:00:11,550,1,
15.10.2023 12:10:12,550,1,
15.10.2023 12:20:12,550,1,
15.10.2023 12:30:13,550,1,
15.10.2023 12:40:14,550,1,
15.10.2023 12:40:14,550,1,
15.10.2023 12:50:14,550,1,
15.10.2023 13:00:15,550,1,
15.10.2023 13:10:15,550,1,
15.10.2023 13:20:15,550,1,
15.10.2023 13:30:16,550,1,
15.10.2023 13:40:16,550,1,
15.10.2023 13:40:16,550,1,
15.10.2023 13:50:17,550,1,
15.10.2023 14:00:17,550,1,
15.10.2023 14:10:18,550,1,
15.10.2023 14:20:18,550,1,
15.10.2023 14:30:19,550,1,
15.10.2023 14:40:19,550,1,
15.10.2023 14:40:19,550,1,
15.10.2023 14:50:20,550,1,
15.10.2023 15:00:20,550,1,
15.10.2023 15:10:21,550,1,
15.10.2023 15:20:21,550,1,
15.10.2023 15:30:22,550,1,
15.10.2023 15:40:22,550,1,
15.10.2023 15:40:22,550,1,
15.10.2023 15:50:22,550,1,
15.10.2023 16:00:23,550,1,
15.10.2023 16:10:23,550,1,
15.10.2023 16:20:24,550,1,
15.10.2023 16:30:24,550,1,
15.10.2023 16:40:25,550,1,
15.10.2023 16:40:25,550,1,
15.10.2023 16:50:25,550,1,
15.10.2023 17:00:26,550,1,
15.10.2023 17:10:26,550,1,
15.10.2023 17:20:27,550,1,
15.10.2023 17:30:27,550,1,
15.10.2023 17:40:28,550,1,
15.10.2023 17:40:28,550,1,
15.10.2023 17:50:28,550,1,
15.10.2023 18:00:29,550,1,
15.10.2023 18:10:29,550,1,
15.10.2023 18:20:29,550,1,
15.10.2023 18:30:30,550,1,
15.10.2023 18:40:30,550,1,
15.10.2023 18:40:30,550,1,
15.10.2023 18:50:35,550,1,
15.10.2023 19:00:39,550,1,
15.10.2023 19:10:40,550,1,
15.10.2023 19:20:40,550,1,
15.10.2023 19:30:41,550,1,
15.10.2023 19:40:41,550,1,
15.10.2023 19:40:41,550,1,
15.10.2023 19:50:42,550,1,
15.10.2023 20:00:42,550,1,
15.10.2023 20:10:43,550,1,
15.10.2023 20:20:43,550,1,
15.10.2023 20:30:44,550,1,
15.10.2023 20:40:44,550,1,
15.10.2023 20:40:44,550,1,
15.10.2023 20:50:45,550,1,
15.10.2023 21:00:45,550,1,
15.10.2023 21:10:45,550,1,
15.10.2023 21:20:46,550,1,
15.10.2023 21:30:46,550,1,
15.10.2023 21:40:47,550,1,
15.10.2023 21:40:47,550,1,
15.10.2023 21:50:47,550,1,
15.10.2023 22:00:48,550,1,
15.10.2023 22:10:48,550,1,
15.10.2023 22:20:49,550,1,
15.10.2023 22:30:49,550,1,
15.10.2023 22:40:49,550,1,
15.10.2023 22:40:49,550,1,
15.10.2023 22:50:50,550,1,
15.10.2023 23:00:50,550,1,
15.10.2023 23:10:51,550,1,
15.10.2023 23:20:51,550,1,
15.10.2023 23:30:52,550,1,
15.10.2023 23:40:52,550,1,
15.10.2023 23:40:52,550,1,
15.10.2023 23:50:53,550,1,
