TimeStamp,ValueNum,Validity,ValueString
11.10.2023 00:03:21,533.2892,1,
11.10.2023 00:13:21,534.5171,1,
11.10.2023 00:23:22,536.1249,1,
11.10.2023 00:33:22,538.0111,1,
11.10.2023 00:43:22,537.682,1,
11.10.2023 00:53:23,538.2643,1,
11.10.2023 01:03:23,538.3023,1,
11.10.2023 01:13:24,536.2261,1,
11.10.2023 01:23:24,535.7324,1,
11.10.2023 01:33:24,534.5931,1,
11.10.2023 01:43:25,531.2258,1,
11.10.2023 01:53:25,531.2004,1,
11.10.2023 02:03:25,533.5044,1,
11.10.2023 02:13:26,534.5551,1,
11.10.2023 02:23:26,536.8083,1,
11.10.2023 02:33:27,537.8591,1,
11.10.2023 02:43:27,537.8338,1,
11.10.2023 02:53:28,538.4922,1,
11.10.2023 03:03:28,538.1123,1,
11.10.2023 03:13:28,536.5552,1,
11.10.2023 03:23:29,536.4667,1,
11.10.2023 03:33:29,534.15,1,
11.10.2023 03:43:29,531.1118,1,
11.10.2023 03:53:30,530.7827,1,
11.10.2023 04:03:30,533.0107,1,
11.10.2023 04:13:31,535.0361,1,
11.10.2023 04:23:31,536.7198,1,
11.10.2023 04:33:35,538.2896,1,
11.10.2023 04:43:36,537.5933,1,
11.10.2023 04:53:36,538.1757,1,
11.10.2023 05:03:37,537.8591,1,
11.10.2023 05:13:37,536.5806,1,
11.10.2023 05:23:38,536.1881,1,
11.10.2023 05:33:38,533.6816,1,
11.10.2023 05:43:39,530.4409,1,
11.10.2023 05:53:39,531.2637,1,
11.10.2023 06:03:39,532.6436,1,
11.10.2023 06:13:40,534.8209,1,
11.10.2023 06:23:40,535.5425,1,
11.10.2023 06:33:41,536.454,1,
11.10.2023 06:43:41,537.2009,1,
11.10.2023 06:53:41,537.4161,1,
11.10.2023 07:03:42,536.7957,1,
11.10.2023 07:13:42,535.4792,1,
11.10.2023 07:23:45,535.0363,1,
11.10.2023 07:33:45,532.998,1,
11.10.2023 07:43:45,530.1497,1,
11.10.2023 07:53:46,530.3396,1,
11.10.2023 08:03:46,531.6942,1,
11.10.2023 08:13:46,534.4412,1,
11.10.2023 08:23:47,535.4159,1,
11.10.2023 08:33:47,535.8843,1,
11.10.2023 08:43:47,536.5426,1,
11.10.2023 08:53:48,536.454,1,
11.10.2023 09:03:48,535.7451,1,
11.10.2023 09:13:49,534.8589,1,
11.10.2023 09:23:49,534.6816,1,
11.10.2023 09:33:49,532.479,1,
11.10.2023 09:43:50,528.9724,1,
11.10.2023 09:53:50,528.9597,1,
11.10.2023 10:03:50,530.6561,1,
11.10.2023 10:13:51,532.8589,1,
11.10.2023 10:23:51,535.0615,1,
11.10.2023 10:33:51,536.1755,1,
11.10.2023 10:43:52,536.6818,1,
11.10.2023 10:53:52,537.0616,1,
11.10.2023 11:03:53,535.3906,1,
11.10.2023 11:13:53,534.4285,1,
11.10.2023 11:23:54,533.3145,1,
11.10.2023 11:33:54,531.4283,1,
11.10.2023 11:43:54,528.618,1,
11.10.2023 11:53:54,527.985,1,
11.10.2023 12:03:55,529.3522,1,
11.10.2023 12:13:55,531.6309,1,
11.10.2023 12:23:56,533.8462,1,
11.10.2023 12:33:56,534.188,1,
11.10.2023 12:43:56,534.9222,1,
11.10.2023 12:53:57,535.3779,1,
11.10.2023 13:03:57,534.2006,1,
11.10.2023 13:13:58,533.8462,1,
11.10.2023 13:23:58,533.0107,1,
11.10.2023 13:33:58,530.6815,1,
11.10.2023 13:43:59,528.0483,1,
11.10.2023 13:53:59,528.2255,1,
11.10.2023 14:04:00,529.3522,1,
11.10.2023 14:14:00,531.4282,1,
11.10.2023 14:24:00,533.1246,1,
11.10.2023 14:34:01,533.6183,1,
11.10.2023 14:44:01,534.6564,1,
11.10.2023 14:54:01,535.0742,1,
11.10.2023 15:04:02,533.6943,1,
11.10.2023 15:14:02,533.6943,1,
11.10.2023 15:24:02,532.4283,1,
11.10.2023 15:34:03,529.9218,1,
11.10.2023 15:44:03,527.2761,1,
11.10.2023 15:54:04,527.618,1,
11.10.2023 16:04:04,528.4028,1,
11.10.2023 16:14:04,530.7448,1,
11.10.2023 16:24:04,531.7701,1,
11.10.2023 16:34:04,532.6436,1,
11.10.2023 16:44:05,533.2892,1,
11.10.2023 16:54:05,534.3525,1,
11.10.2023 17:04:06,532.5549,1,
11.10.2023 17:14:06,532.2133,1,
11.10.2023 17:24:06,531.8461,1,
11.10.2023 17:34:07,529.1497,1,
11.10.2023 17:44:07,527.504,1,
11.10.2023 17:54:08,527.0989,1,
11.10.2023 18:04:08,527.8964,1,
11.10.2023 18:14:09,530.4536,1,
11.10.2023 18:24:09,531.6942,1,
11.10.2023 18:34:09,532.1879,1,
11.10.2023 18:44:10,534.1247,1,
11.10.2023 18:54:11,534.0109,1,
11.10.2023 19:04:11,532.5676,1,
11.10.2023 19:14:12,532.5297,1,
11.10.2023 19:24:12,531.5422,1,
11.10.2023 19:34:13,529.0737,1,
11.10.2023 18:44:10,534.1247,1,
11.10.2023 18:44:10,534.1247,1,
11.10.2023 18:54:11,534.0109,1,
11.10.2023 18:54:11,534.0109,1,
11.10.2023 19:04:11,532.5676,1,
11.10.2023 19:04:11,532.5676,1,
11.10.2023 19:14:12,532.5297,1,
11.10.2023 19:14:12,532.5297,1,
11.10.2023 19:24:12,531.5422,1,
11.10.2023 19:24:12,531.5422,1,
11.10.2023 19:34:13,529.0737,1,
11.10.2023 19:34:13,529.0737,1,
11.10.2023 19:44:13,526.7697,1,
11.10.2023 19:54:14,526.9722,1,
11.10.2023 20:04:14,528.3901,1,
11.10.2023 20:14:15,530.6941,1,
11.10.2023 20:24:15,531.8841,1,
11.10.2023 20:34:15,532.2891,1,
11.10.2023 20:44:16,533.4411,1,
11.10.2023 20:54:16,534.1754,1,
11.10.2023 21:04:16,532.3018,1,
11.10.2023 21:14:17,532.4663,1,
11.10.2023 21:24:17,531.3016,1,
11.10.2023 21:34:18,528.3901,1,
11.10.2023 21:44:18,526.6558,1,
11.10.2023 21:54:19,526.8203,1,
11.10.2023 22:04:19,527.8457,1,
11.10.2023 22:14:19,530.1497,1,
11.10.2023 22:24:20,531.8334,1,
11.10.2023 22:34:20,531.6688,1,
11.10.2023 22:44:21,533.0107,1,
11.10.2023 22:54:21,533.1246,1,
11.10.2023 23:04:22,531.5676,1,
11.10.2023 23:14:22,531.0739,1,
11.10.2023 23:24:22,531.5676,1,
11.10.2023 23:24:22,531.5676,1,
11.10.2023 23:34:23,528.0103,1,
11.10.2023 23:34:23,528.0103,1,
11.10.2023 23:44:23,526.1368,1,
11.10.2023 23:54:24,526.2761,1,
