TimeStamp,ValueNum,Validity,ValueString
11.10.2023 00:23:22,30,1,
11.10.2023 01:23:24,30,1,
11.10.2023 02:23:26,30,1,
11.10.2023 03:23:29,30,1,
11.10.2023 04:23:31,30,1,
11.10.2023 05:23:38,30,1,
11.10.2023 06:23:40,30,1,
11.10.2023 07:23:45,30,1,
11.10.2023 08:23:47,30,1,
11.10.2023 09:23:49,30,1,
11.10.2023 10:23:51,30,1,
11.10.2023 11:23:54,30,1,
11.10.2023 12:23:56,30,1,
11.10.2023 13:23:58,30,1,
11.10.2023 14:24:00,30,1,
11.10.2023 15:24:02,30,1,
11.10.2023 16:24:04,30,1,
11.10.2023 17:24:06,30,1,
11.10.2023 18:24:09,30,1,
11.10.2023 19:24:12,30,1,
11.10.2023 19:24:12,30,1,
11.10.2023 19:24:12,30,1,
11.10.2023 20:24:15,30,1,
11.10.2023 21:24:17,30,1,
11.10.2023 22:24:20,30,1,
11.10.2023 23:24:22,30,1,
11.10.2023 23:24:22,30,1,
