TimeStamp,ValueNum,Validity,ValueString
13.10.2023 00:05:56,524.1367,1,
13.10.2023 00:15:56,525.5671,1,
13.10.2023 00:25:57,525.8583,1,
13.10.2023 00:35:57,526.9343,1,
13.10.2023 00:45:57,528.0989,1,
13.10.2023 00:55:58,527.4534,1,
13.10.2023 01:05:58,526.3013,1,
13.10.2023 01:15:58,526.3647,1,
13.10.2023 01:25:59,525.5925,1,
13.10.2023 01:35:59,523.3012,1,
13.10.2023 01:46:00,521.3896,1,
13.10.2023 01:56:00,521.0731,1,
13.10.2023 02:06:00,523.7821,1,
13.10.2023 02:16:01,525.8077,1,
13.10.2023 02:26:01,525.8962,1,
13.10.2023 02:36:02,526.8077,1,
13.10.2023 02:46:02,528.2509,1,
13.10.2023 02:56:03,527.0989,1,
13.10.2023 03:06:03,526.5926,1,
13.10.2023 03:16:04,527.2128,1,
13.10.2023 03:26:04,524.8329,1,
13.10.2023 03:36:04,522.6428,1,
13.10.2023 03:46:05,520.6807,1,
13.10.2023 03:56:05,520.1238,1,
13.10.2023 04:06:06,522.7188,1,
13.10.2023 04:16:06,524.8835,1,
13.10.2023 04:26:07,524.7316,1,
13.10.2023 04:36:07,526.6812,1,
13.10.2023 04:46:07,527.6432,1,
13.10.2023 04:56:08,527.2509,1,
13.10.2023 05:06:08,525.9849,1,
13.10.2023 05:16:09,526.2887,1,
13.10.2023 05:26:09,524.9342,1,
13.10.2023 05:36:09,522.415,1,
13.10.2023 05:46:10,520.5793,1,
13.10.2023 05:56:10,520.3642,1,
13.10.2023 06:06:11,522.6175,1,
13.10.2023 06:16:11,524.7189,1,
13.10.2023 06:26:12,525.1621,1,
13.10.2023 06:36:12,526.1874,1,
13.10.2023 06:46:12,527.58,1,
13.10.2023 06:56:13,525.8962,1,
13.10.2023 07:06:13,525.8329,1,
13.10.2023 07:16:14,526.0735,1,
13.10.2023 07:26:14,524.0228,1,
13.10.2023 07:36:14,521.82,1,
13.10.2023 07:46:15,520.2629,1,
13.10.2023 07:56:15,519.7566,1,
13.10.2023 08:06:16,522.7695,1,
13.10.2023 08:16:16,525.2,1,
13.10.2023 08:26:17,525.0608,1,
13.10.2023 08:36:17,525.4912,1,
13.10.2023 08:46:17,527.2888,1,
13.10.2023 08:56:17,526.3267,1,
13.10.2023 09:06:18,525.39,1,
13.10.2023 09:16:18,525.4785,1,
13.10.2023 09:26:18,523.7695,1,
13.10.2023 09:36:19,519.7566,1,
13.10.2023 09:46:19,518.9843,1,
13.10.2023 09:56:19,519.1236,1,
13.10.2023 10:06:19,521.4781,1,
13.10.2023 10:16:19,523.3264,1,
13.10.2023 10:26:19,524.162,1,
13.10.2023 10:36:19,525.0862,1,
13.10.2023 10:46:19,526.5546,1,
13.10.2023 10:56:20,525.2887,1,
13.10.2023 11:06:20,523.5923,1,
13.10.2023 11:16:20,524.0481,1,
13.10.2023 11:26:20,522.5035,1,
13.10.2023 11:36:20,518.3387,1,
13.10.2023 11:46:20,518.402,1,
13.10.2023 11:56:20,517.5286,1,
13.10.2023 12:06:20,520.9592,1,
13.10.2023 12:16:20,522.0605,1,
13.10.2023 12:26:20,522.4023,1,
13.10.2023 12:36:20,523.8075,1,
13.10.2023 12:46:20,524.7822,1,
13.10.2023 12:57:24,523.5923,1,
13.10.2023 13:07:24,522.6301,1,
13.10.2023 13:17:24,522.5795,1,
13.10.2023 13:27:24,521.6301,1,
13.10.2023 13:37:24,517.1361,1,
13.10.2023 13:47:24,516.9842,1,
13.10.2023 13:57:24,516.6172,1,
13.10.2023 14:07:24,519.7946,1,
13.10.2023 14:17:25,521.377,1,
13.10.2023 14:27:25,521.5162,1,
13.10.2023 14:37:26,522.5669,1,
13.10.2023 14:47:26,523.8961,1,
13.10.2023 14:57:27,523.2125,1,
13.10.2023 15:07:27,522.6935,1,
13.10.2023 15:17:27,522.6682,1,
13.10.2023 15:27:28,521.2756,1,
13.10.2023 15:37:28,516.9082,1,
13.10.2023 15:47:29,516.3766,1,
13.10.2023 15:57:29,516.136,1,
13.10.2023 16:07:30,519.073,1,
13.10.2023 16:17:30,519.9338,1,
13.10.2023 16:27:30,520.5795,1,
13.10.2023 16:37:31,521.7694,1,
13.10.2023 16:47:31,522.6935,1,
13.10.2023 16:57:32,522.4656,1,
13.10.2023 17:07:32,520.9592,1,
13.10.2023 17:17:32,521.5922,1,
13.10.2023 17:27:33,519.9591,1,
13.10.2023 17:37:33,516.25,1,
13.10.2023 17:47:34,515.3132,1,
13.10.2023 17:57:34,515.5284,1,
13.10.2023 18:07:35,517.6553,1,
13.10.2023 18:17:35,518.6553,1,
13.10.2023 18:27:36,519.8199,1,
13.10.2023 18:37:36,520.6554,1,
13.10.2023 18:47:37,522.2631,1,
13.10.2023 18:57:38,521.6301,1,
13.10.2023 19:07:38,520.7187,1,
13.10.2023 19:17:39,521.3517,1,
13.10.2023 19:27:39,519.3388,1,
13.10.2023 19:37:40,515.8069,1,
13.10.2023 19:47:41,514.7562,1,
13.10.2023 19:57:41,514.541,1,
13.10.2023 20:07:42,516.5792,1,
13.10.2023 20:17:42,518.5033,1,
13.10.2023 20:27:43,518.6806,1,
13.10.2023 20:37:45,519.3135,1,
13.10.2023 20:47:48,521.1364,1,
13.10.2023 20:57:49,520.0478,1,
13.10.2023 21:07:50,519.9718,1,
13.10.2023 21:17:50,520.1238,1,
13.10.2023 21:27:51,518.6553,1,
13.10.2023 21:37:51,515.2626,1,
13.10.2023 21:47:52,513.8448,1,
13.10.2023 21:57:52,513.5789,1,
13.10.2023 22:07:53,516.1614,1,
13.10.2023 22:17:54,516.845,1,
13.10.2023 22:27:54,517.3893,1,
13.10.2023 22:37:54,518.5667,1,
13.10.2023 22:47:55,519.5034,1,
13.10.2023 22:57:56,519.5667,1,
13.10.2023 23:07:56,518.4401,1,
13.10.2023 23:17:57,519.2882,1,
13.10.2023 23:27:57,517.0602,1,
13.10.2023 23:37:58,513.7814,1,
13.10.2023 23:47:58,512.6927,1,
13.10.2023 23:57:59,512.8447,1,
