TimeStamp,ValueNum,Validity,ValueString
18.10.2023 00:03:32,550,1,
18.10.2023 00:13:32,550,1,
18.10.2023 00:23:32,550,1,
18.10.2023 00:33:32,550,1,
18.10.2023 00:43:33,550,1,
18.10.2023 01:00:07,550,1,
18.10.2023 01:10:07,550,1,
18.10.2023 01:20:07,550,1,
18.10.2023 01:30:08,550,1,
18.10.2023 01:40:08,550,1,
18.10.2023 01:50:09,550,1,
18.10.2023 02:11:01,550,1,
18.10.2023 02:21:01,550,1,
18.10.2023 02:31:01,550,1,
18.10.2023 02:41:02,550,1,
18.10.2023 02:41:02,550,1,
18.10.2023 02:51:02,550,1,
18.10.2023 02:51:02,550,1,
18.10.2023 03:01:02,550,1,
18.10.2023 03:01:02,550,1,
18.10.2023 03:16:35,550,1,
18.10.2023 03:16:35,550,1,
18.10.2023 03:26:36,550,1,
18.10.2023 03:26:36,550,1,
18.10.2023 03:36:39,550,1,
18.10.2023 03:46:42,550,1,
18.10.2023 03:56:43,550,1,
18.10.2023 04:06:46,550,1,
18.10.2023 04:25:57,550,1,
18.10.2023 04:35:59,550,1,
18.10.2023 03:36:39,550,1,
18.10.2023 03:36:39,550,1,
18.10.2023 03:46:42,550,1,
18.10.2023 03:46:42,550,1,
18.10.2023 03:56:43,550,1,
18.10.2023 03:56:43,550,1,
18.10.2023 04:06:46,550,1,
18.10.2023 04:06:46,550,1,
18.10.2023 04:25:57,550,1,
18.10.2023 04:25:57,550,1,
18.10.2023 04:35:59,550,1,
18.10.2023 04:35:59,550,1,
18.10.2023 04:45:59,550,1,
18.10.2023 04:55:59,550,1,
18.10.2023 05:06:00,550,1,
18.10.2023 05:16:00,550,1,
18.10.2023 05:32:38,550,1,
18.10.2023 05:42:38,550,1,
18.10.2023 05:52:39,550,1,
18.10.2023 06:02:39,550,1,
18.10.2023 06:12:39,550,1,
18.10.2023 06:22:39,550,1,
18.10.2023 06:36:10,550,1,
18.10.2023 06:46:11,550,1,
18.10.2023 06:56:11,550,1,
18.10.2023 07:06:11,550,1,
18.10.2023 07:16:11,550,1,
18.10.2023 07:26:12,550,1,
18.10.2023 07:42:46,550,1,
18.10.2023 07:52:47,550,1,
18.10.2023 08:02:47,550,1,
18.10.2023 08:12:48,550,1,
18.10.2023 08:22:48,550,1,
18.10.2023 08:32:48,550,1,
18.10.2023 08:49:03,550,1,
18.10.2023 08:59:03,550,1,
18.10.2023 09:09:04,550,1,
18.10.2023 09:19:04,550,1,
18.10.2023 09:29:04,550,1,
18.10.2023 09:39:05,550,1,
18.10.2023 09:54:36,550,1,
18.10.2023 10:04:37,550,1,
18.10.2023 10:14:37,550,1,
18.10.2023 10:24:37,550,1,
18.10.2023 10:34:38,550,1,
18.10.2023 10:44:38,550,1,
18.10.2023 10:58:30,550,1,
18.10.2023 11:08:30,550,1,
18.10.2023 11:18:30,550,1,
18.10.2023 11:28:30,550,1,
18.10.2023 11:38:31,550,1,
18.10.2023 11:48:31,550,1,
18.10.2023 12:05:46,550,1,
18.10.2023 12:15:47,550,1,
18.10.2023 12:25:47,550,1,
18.10.2023 12:35:47,550,1,
18.10.2023 12:45:47,550,1,
18.10.2023 12:55:48,550,1,
18.10.2023 13:13:20,550,1,
18.10.2023 13:23:20,550,1,
18.10.2023 13:33:20,550,1,
18.10.2023 13:43:21,550,1,
18.10.2023 13:53:21,550,1,
18.10.2023 14:03:21,550,1,
18.10.2023 14:17:59,550,1,
18.10.2023 14:28:00,550,1,
18.10.2023 14:38:00,550,1,
18.10.2023 14:48:00,550,1,
18.10.2023 14:58:00,550,1,
18.10.2023 15:08:01,550,1,
18.10.2023 15:29:03,550,1,
18.10.2023 15:39:05,550,1,
18.10.2023 15:49:07,550,1,
18.10.2023 15:59:07,550,1,
18.10.2023 16:09:08,550,1,
18.10.2023 16:22:21,550,1,
18.10.2023 16:32:22,550,1,
18.10.2023 16:42:22,550,1,
18.10.2023 16:52:23,550,1,
18.10.2023 17:02:24,550,1,
18.10.2023 17:12:24,550,1,
18.10.2023 17:25:45,550,1,
18.10.2023 17:35:45,550,1,
18.10.2023 16:42:22,550,1,
18.10.2023 16:42:22,550,1,
18.10.2023 16:52:23,550,1,
18.10.2023 16:52:23,550,1,
18.10.2023 17:02:24,550,1,
18.10.2023 17:02:24,550,1,
18.10.2023 17:12:24,550,1,
18.10.2023 17:12:24,550,1,
18.10.2023 17:25:45,550,1,
18.10.2023 17:25:45,550,1,
18.10.2023 17:35:45,550,1,
18.10.2023 17:35:45,550,1,
18.10.2023 17:45:46,550,1,
18.10.2023 17:55:46,550,1,
18.10.2023 18:05:47,550,1,
18.10.2023 18:15:48,550,1,
18.10.2023 18:29:55,550,1,
18.10.2023 18:39:56,550,1,
18.10.2023 18:50:02,550,1,
18.10.2023 19:00:03,550,1,
18.10.2023 19:10:03,550,1,
18.10.2023 19:20:04,550,1,
18.10.2023 19:34:04,550,1,
18.10.2023 19:44:04,550,1,
18.10.2023 19:54:05,550,1,
18.10.2023 20:04:05,550,1,
18.10.2023 20:14:06,550,1,
18.10.2023 20:24:07,550,1,
18.10.2023 20:36:50,550,1,
18.10.2023 20:46:51,550,1,
18.10.2023 20:56:52,550,1,
18.10.2023 21:06:52,550,1,
18.10.2023 21:16:53,550,1,
18.10.2023 21:26:54,550,1,
18.10.2023 21:39:59,550,1,
18.10.2023 21:50:00,550,1,
18.10.2023 22:00:01,550,1,
18.10.2023 22:10:02,550,1,
18.10.2023 22:20:02,550,1,
18.10.2023 22:30:03,550,1,
18.10.2023 22:43:37,550,1,
18.10.2023 22:53:38,550,1,
18.10.2023 23:03:38,550,1,
18.10.2023 23:13:39,550,1,
18.10.2023 23:23:40,550,1,
18.10.2023 23:33:41,550,1,
18.10.2023 23:48:16,550,1,
18.10.2023 23:58:16,550,1,
